FFFFFFFF
FFFFFFFF
F_FFFFFF
F__FFFFF
F__FFFFF
FFFFF___
FFFF__FF
FFFFF_FF