FFFFFFFF
FFFFFFFF
F_FSGFFF
F__GFSFF
F__GGFFF
FFFFF___
FSFF__FG
FFFFF_GG