ffffffff
f______f
f__gg__f
f_gVFg_f
f__Sg__f
f______f
f______f
ffffffff